en-US	English (US) - English (US)
ach	Acholi - Acholi
af	Afrikaans - Afrikaans
sq	Albanian - Shqip
ar	Arabic - عربي
an	Aragonese - aragonés
hy-AM	Armenian - Հայերեն
ast	Asturian - Asturianu
az	Azerbaijani - Azərbaycanca
eu	Basque - Euskara
be	Belarusian - Беларуская
bn	Bengali - বাংলা
bs	Bosnian - Bosanski
br	Breton - Brezhoneg
bg	Bulgarian - Български
my	Burmese - မြန်မာဘာသာ
ca	Catalan - Català
ca-valencia	Catalan (Valencian) - Català (Valencià)
zh-CN	Chinese (Simplified) - 中文 (简体)
zh-TW	Chinese (Traditional) - 正體中文 (繁體)
hr	Croatian - Hrvatski
cs	Czech - Čeština
da	Danish - Dansk
nl	Dutch - Nederlands
en-GB	English (British) - English (British)
en-CA	English (Canadian) - English (Canadian)
eo	Esperanto - Esperanto
et	Estonian - Eesti keel
fi	Finnish - suomi
fr	French - Français
fy-NL	Frisian - Frysk
fur	Friulian - Furlan
ff	Fulah - Pulaar-Fulfulde
gd	Gaelic (Scotland) - Gàidhlig
gl	Galician - Galego
ka	Georgian - ქართული
de	German - Deutsch
el	Greek - Ελληνικά
gn	Guarani - Avañe'ẽ
gu-IN	Gujarati (India) - ગુજરાતી (ભારત)
he	Hebrew - עברית
hi-IN	Hindi (India) - हिन्दी (भारत)
hu	Hungarian - magyar
is	Icelandic - íslenska
id	Indonesian - Bahasa Indonesia
ia	Interlingua - Interlingua
ga-IE	Irish - Gaeilge
it	Italian - Italiano
ja	Japanese - 日本語
kab	Kabyle - Taqbaylit
kn	Kannada - ಕನ್ನಡ
cak	Kaqchikel - Maya Kaqchikel
kk	Kazakh - Қазақ
km	Khmer - ខ្មែរ
ko	Korean - 한국어
lv	Latvian - Latviešu
lij	Ligurian - Ligure
lt	Lithuanian - Lietuvių
dsb	Lower Sorbian - Dolnoserbšćina
mk	Macedonian - Македонски
ms	Malay - Melayu
mr	Marathi - मराठी
ne-NP	Nepali - नेपाली
nb-NO	Norwegian (Bokmål) - Norsk bokmål
nn-NO	Norwegian (Nynorsk) - Norsk nynorsk
oc	Occitan (Lengadocian) - occitan (lengadocian)
fa	Persian - فارسی
pl	Polish - Polski
pt-BR	Portuguese (Brazilian) - Português (do&nbsp;Brasil)
pt-PT	Portuguese (Portugal) - Português (Europeu)
pa-IN	Punjabi (India) - ਪੰਜਾਬੀ (ਭਾਰਤ)
ro	Romanian - Română
rm	Romansh - rumantsch
ru	Russian - Русский
sat	Santali - ᱥᱟᱱᱛᱟᱲᱤ
skr	Saraiki - سرائیکی
sc	Sardinian - Sardu
sco	Scots - Scots
sr	Serbian - Српски
szl	Silesian - Ślōnsko godka
si	Sinhala - සිංහල
sk	Slovak - slovenčina
sl	Slovenian - Slovenščina
son	Songhai - Soŋay
es-AR	Spanish (Argentina) - Español (de Argentina)
es-CL	Spanish (Chile) - Español (de Chile)
es-MX	Spanish (Mexico) - Español (de México)
es-ES	Spanish (Spain) - Español (de España)
sv-SE	Swedish - Svenska
tl	Tagalog - Tagalog
tg	Tajik - Тоҷикӣ
ta	Tamil - தமிழ்
te	Telugu - తెలుగు
th	Thai - ไทย
trs	Triqui - Triqui
tr	Turkish - Türkçe
uk	Ukrainian - Українська
hsb	Upper Sorbian - Hornjoserbsce
ur	Urdu - اُردو
uz	Uzbek - Oʻzbek tili
vi	Vietnamese - Tiếng Việt
cy	Welsh - Cymraeg
xh	Xhosa - isiXhosa
